##########
#   #    #
#   #    #
#S  #   G#
#   #    #
#   #    #
#   #    #
##########