##G### ##
## ##  ##
##    ###
#####  ##
#     ###
# # #####
#S# #####