###############################
#S  #   #           #         #
### # # # ######### ### #######
# # # #   # #       #   #     #
# # # ##### # ####### # # ### #
# #   #   #   #   #   # #   # #
# ##### ### ### # ### ### ### #
#       #   #   #   #     #   #
# ### ### ##### ### # ##### # #
# #   #   #     # # # #     # #
# # # # ### ##### # ### ##### #
# # # #     # #   #   #     # #
# # # ####### # # ### # ### # #
# # #     #     #     # #   # #
# # ####### ########### # ### #
# #   #   # #   #     # # #   #
# ### # # # # # # ##### # # ###
#   #   # #   # #   #   # #   #
# ####### ##### ### # ### #####
# #       #   #   #   #   #   #
# # ##### # ##### ##### ### # #
# #   #     #   #     #     # #
# ### ####### # ##### ### ### #
# #   #       #     #   # #   #
# # ### ######### ##### # # ###
# #   # #G#     # #   # # #   #
# ### # # # # ### # # # ##### #
#   #   #   #   # # #   #     #
### ########### # # ##### ### #
#               #         #   #
###############################