###################################################
S     # #                               #         #
##### # # ####################### ##### ### ### # #
#     #   #       #           #   #   #   # #   # #
# ##### ##### ### # ######### # ### # ### ### ### #
# #   #     #   # #   #     #   #   #   #     # # #
# # ####### # ### ### ##### ##### ##### ####### # #
# #         # #   # # #     #     #   #     #     #
# # ##### ##### # # # # ##### ##### ##### ### #####
# # #   #       # # # # #   #   #       #     #   #
# ### # ######### # # # # # ### # ### ######### # #
#     # #           # # # #     #   #           # #
####### ##### ####### # # ######### ### ######### #
#     #     # #       #   #   #   #   #         # #
##### ##### ### ####### ### ### # ### ######### ###
#     #   #     # #     #       #       #   # #   #
# ### # # ####### # ####### ########### # # # ### #
# #   # #     #     #     # #         #   #   #   #
# ##### ### ### ####### # ### ####### ######### # #
#         #             #     #                 # G
###################################################